W000f00000000F
000W^c000<-->0
W00f|000000000
0A0W|Ggg^00000
0W00|000|Z0000
0000v0c0vzA0S0
x00000000z00^0
<->0<---->00|0
s00000000A00v0
000A00^0S00000
f000f0|000000F
00000f|00<--->
0A0fA0|0000000
w00000v00000A0
0A00A00000000A
0f0S00Nnn00S0F
