000f000000W0000W0f000w0000f00000
0WW0000000GggGggGgg0w00A0000WW00
000f00000000000x0000000000000000
0f000Z00Z00w0000ww00000000000000
00S00z0Xz00000000000^F0<---->000
00A00z00z00000000000|00000Z00000
00C00Z00Z00000000000|00000z00000
c0000z0Wz00000M00000|W00C0z0000x
00000z00z00000000000|00000Z<--->
00X00f00<---->00Nnn0v000F0zff000
0f00ff000000000s0000000000z00000
0f000f0000000A000000000000000000
0000000B0w000w00w00000B00S00fffff
f00A000000000000w0000000000ff00W
WW000f00000<-------->00A000wWW00
WW0f00A00000000s00000000000f0W0w