000000000000000^*^00000000000000
0*0000000000000|0|Z000Ggg00000*0
A00B00Ggg000000|0|z0000000000000
ZA000000000Nnn0v0vz000000000000A
z0A000000000000000000Ggg000f00A0
zA0A00000w000W00000W0000000000wA
f0A0A000Z00000000000000wPp0f000Z
fA0A0000z000000000000000pp00000z
w0A00000z00000000000000w0000000z
fA00Z00000000W00W00W000f00000000
A000z00w0000000000000000Nnn0000^
0000z0000000000Ggg000Z000000000|
000000000Nnn000000f00z000000000|
0000000Aw000000000000z000000B00|
0*0000AfA000A00000A000000f0000*|
00000AfffAAA0AAANnnAA0000000000v
