W0w0^0000w000S00<-->0w0A000Nnn00
000W|0000<-->000A0000000A00<->00
W00f|Ggg0000ZZ0S000Nnn00A00S0000
0A0W|Ggg^000zz00^00^000w00Nnn000
000W|000|000zz00|00|0w00000A0000
W0W0v000v0A00000v00vw00w0w000w00
0000000fff0000f0000Ggg0000A00w00
<->0<---->00^0f0AA<-->000<----->
000000^00000|S0w00GggGgg0000f000
000A00|0000w|00000^00f<-->Z00f00
f000f0|S0000vNnn00|00A0f00z00000
00000f|00<--->0000V000f000z0f000
0A0fA0|000Z00000000000Nnn0000000
0A0SS0v000z0<----------->00Ggg0F
00f0A00000z000A00000f00A00000F0F
0f000000000000f00A0000000000F000