W000W0000^000cNnn00000000cx
00W0000A0|0000f000000000000
W0000A000v0000000f0000A0000
0f0000000c0f00A000000000000
<-->f<->000A00000c<-->ff<->
0000f0000A0000^000f00000000
00000A00f00000|0000000A0000
00s00Ggg000000|000A00000000
0000A000A0000Zv0000000f0002
000000wf00000z0000000000200
000000Nnn0000z00nnn00020002
