AAA000000000
Aw00W0W0W0W0
w00000000000
00x000000c00
00^0000Pp000
00|0000pp000
00v000000000
ff000<-->0ff
sfGggcsGggfc
ff0<-->000ff
000000000^00
000Pp0000|00
000pp0000v00
00c000000x00
00000000000w
0202020200wA
000000000AAA