<--------------->
^W00NnnZ^ZNnn002^
|0A000fz|zf000A0|
|000000zvz000000|
|W000000s0000002|
|0000000^0000000|
|0A00000|00000A0|
vW000GggvGgg0002v
<--------------->