00F00000
00F00000
0BBPp000
000pp000
W0W000S0
AAW0000M