00F000t0
00F000v0
0BBPp0b0
000pp000
W0W000S0
AAW0lhrM